You are Pat the Baker, a humble baker with a rather odd habit. In your sleep, it seems you occasionally sleepwalk. Not only that, but in your slumbering stride you seem to hide various ingredients throughout the house! It seems last night was one of those nights. How unlucky, considering you need to bake a cake today. You better search the house for everything you'll need!

Cake Quest
An Interactive Fiction by Jordan Hyman and Francisco Perez
Release 1 / Serial number 150601 / Inform 7 build 6L38 (I6/v6.33 lib 6/12N) SD

Kitchen
An ordinary kitchen, just like any other. Inside are all the tools necessary to bake a cake. Too bad the necessary ingredients aren't here as well. To the south is the Living Room.

>look
Kitchen
An ordinary kitchen, just like any other. Inside are all the tools necessary to bake a cake. Too bad the necessary ingredients aren't here as well.

>go south
Living Room
The Living Room is a place of relaxation for you. Within you can see your comfortable couch, addorned with some new throw pillows resting on each side, and your big-screen TV.

You can see a left throw pillow and a right throw pillow here.

>inspect right throw pillow
That's not a verb I recognise.

>look at right throw pillow
This isn't a throw pillow at all! It's actually a bag of sugar!

>take right throw pillow
That isn't available.

* * *

>go south
Living Room
The Living Room is a place of relaxation for you. Within you can see your comfortable couch and your big-screen TV. To the north is the Kitchen, to the east is the Bathroom, to the west is the Bedroom, to the south is the Backyard, upstairs is the Attic, and downstairs is the Basement.

You can see a couch (on which are a left throw pillow and a right throw pillow) here.

>look at right throw pillow
This isn't a throw pillow at all! It's actually a bag of sugar!

* * *

>take right throw pillow
That isn't available.

>take left throw pillow
That isn't available.

>pick up right throw pillow
You can't see any such thing.

* * *

>go south
Living Room
The Living Room is a place of relaxation for you. Within you can see your comfortable couch and your big-screen TV. To the north is the Kitchen, to the east is the Bathroom, to the west is the Bedroom, to the south is the Backyard, upstairs is the Attic, and downstairs is the Basement.

You can see a couch (on which are a left throw pillow and a right throw pillow) here.

>take left throw pillow
You don't need a pillow to make a cake!

>inventory
You are carrying nothing.

* * *

>inventory
You are carrying:
  a bag of sugar
  a bag of flour

>look
Living Room
The Living Room is a place of relaxation for you. Within you can see your comfortable couch, addorned with some new throw pillows resting on each side, and your big-screen TV.

* * *

>go south
Living Room
The Living Room is a place of relaxation for you. Within you can see your comfortable couch and your big-screen TV. To the north is the Kitchen, to the east is the Bathroom, to the west is the Bedroom, to the south is the Backyard, upstairs is the Attic, and downstairs is the Basement.

You can see a couch (on which are a left throw pillow and a right throw pillow) here.

>go west
Bedroom
The Bedroom: a place to rest your head after a long day's work.

You can see a nighstand (on which is a bottle of eyedrops) here.

>look at bottle of eyedrops
Upon closer inspection, you realized this is actually a bottle of vanilla extract!

* * *

>inventory
You are carrying:
  a bottle of vanilla extract

* * *

>go south
Living Room
The Living Room is a place of relaxation for you. Within you can see your comfortable couch and your big-screen TV. To the north is the Kitchen, to the east is the Bathroom, to the west is the Bedroom, to the south is the Backyard, upstairs is the Attic, and downstairs is the Basement.

You can see a couch (on which are a left throw pillow and a right throw pillow) here.

>look at left throw pillow
This isn't a throw pillow at all! It's actually a bag of flour!

>look at right throw pillow
This isn't a throw pillow at all! It's actually a bag of sugar!

>look
Living Room
The Living Room is a place of relaxation for you. Within you can see your comfortable couch and your big-screen TV.

You can see a couch (on which are a bag of sugar and a bag of flour) here.

>take bag of sugar and bag of flour
bag of sugar: Taken.
bag of flour: Taken.

* * *

>go south
Living Room
The Living Room is a place of relaxation for you. Within you can see your comfortable couch and your big-screen TV. To the north is the Kitchen, to the east is the Bathroom, to the west is the Bedroom, to the south is the Backyard, upstairs is the Attic, and downstairs is the Basement.

You can see a couch (on which are a left throw pillow and a right throw pillow) here.

>go east
Bathroom
The bathroom where you wash up and other bodily functions.

You can see a shower (in which is a bar of soap) here.

>look at bar of soap
This is really a stick of butter!

>look
Bathroom
The bathroom where you wash up and other bodily functions.

You can see a shower (in which is a stick of butter) here.

* * *

>go south
Living Room
The Living Room is a place of relaxation for you. Within you can see your comfortable couch and your big-screen TV. To the north is the Kitchen, to the east is the Bathroom, to the west is the Bedroom, to the south is the Backyard, upstairs is the Attic, and downstairs is the Basement.

You can see a couch (on which are a left throw pillow and a right throw pillow) here.

>look at left throw pillow and right throw pillow
You can't use multiple objects with that verb.

>look at left throw pillow
This isn't a throw pillow at all! It's actually a bag of flour!

* * *

>take bag of sugar and bag of flour
bag of sugar: Taken.
bag of flour: Taken.

>look
Living Room
The Living Room is a place of relaxation for you. Within you can see your comfortable couch and your big-screen TV.

You can see a couch here.

>sit on couch
That's not something you can sit down on.

>go east
Bathroom
The bathroom where you wash up and other bodily functions.

You can see a shower (in which is a bar of soap) here.

* * *

>look at bar of soap
This is really a stick of butter!

>take stick of butter
Taken.

>look
Bathroom
The bathroom where you wash up and other bodily functions.

You can see a shower (empty) here.

>go east
You can't go that way.

>go west
Living Room
The Living Room is a place of relaxation for you. Within you can see your comfortable couch and your big-screen TV.

You can see a couch here.

>go west
Bedroom
The Bedroom: a place to rest your head after a long day's work.

You can see a nightstand (on which is a bottle of eyedrops) here.

>look at eyedrops
Upon closer inspection, you realized this is actually a bottle of vanilla extract!

>take bottle of vanilla extract
Taken.

>go east
Living Room
The Living Room is a place of relaxation for you. Within you can see your comfortable couch and your big-screen TV.

You can see a couch here.

>directions
Which do you mean, the north, the northeast, the northwest, the south, the southeast, the southwest, the east, the west, the up, the down, the inside or the outside?

* * *

>go south
Living Room
The Living Room is a place of relaxation for you. Within you can see your comfortable couch and your big-screen TV. To the north is the Kitchen, to the east is the Bathroom, to the west is the Bedroom, to the south is the Backyard, upstairs is the Attic, and downstairs is the Basement.

You can see a couch (on which are a left throw pillow and a right throw pillow) here.

>go upstairs
Attic
Nothing going on here. Maybe an ingredient will be here later.

>go downstairs
Living Room
The Living Room is a place of relaxation for you. Within you can see your comfortable couch and your big-screen TV. To the north is the Kitchen, to the east is the Bathroom, to the west is the Bedroom, to the south is the Backyard, upstairs is the Attic, and downstairs is the Basement.

You can see a couch (on which are a left throw pillow and a right throw pillow) here.

* * *

>go south
Living Room
The Living Room is a place of relaxation for you. Within you can see your comfortable couch and your big-screen TV. To the north is the Kitchen, to the east is the Bathroom, to the west is the Bedroom, to the south is the Backyard, upstairs is the Attic, and downstairs is the Basement.

You can see a couch (on which are a left throw pillow and a right throw pillow) here.

>go downstairs
Basement
Not much going on here. Basically, the laundry room for you. Upstairs is the Living Room.

You can see a washing machine (closed), a dryer (closed) and a powdered detergent here.

>x detergent
You see nothing special about the powdered detergent.

>look at detergent
You can't see any such thing.

>x detergent
You can't see any such thing.

>look
Basement
Not much going on here. Basically, the laundry room for you. Upstairs is the Living Room.

You can see a baking powder, a washing machine (closed) and a dryer (closed) here.

* * *

>go south
Living Room
The Living Room is a place of relaxation for you. Within you can see your comfortable couch and your big-screen TV. To the north is the Kitchen, to the east is the Bathroom, to the west is the Bedroom, to the south is the Backyard, upstairs is the Attic, and downstairs is the Basement.

You can see a couch (on which are a left throw pillow and a right throw pillow) here.

>d
Basement
Not much going on here. Basically, the laundry room for you. Upstairs is the Living Room.

You can see a washing machine (closed), a dryer (closed) and a powdered detergent here.

* * *

>south
Living Room
The Living Room is a place of relaxation for you. Within you can see your comfortable couch and your big-screen TV.

You can see a couch (on which are a left throw pillow and a right throw pillow) here.

>look
Living Room
The Living Room is a place of relaxation for you. Within you can see your comfortable couch and your big-screen TV.

You can see a couch (on which are a left throw pillow and a right throw pillow) here.

* * *

>inventory
You are carrying:
  a bag of flour

* * *

>south
Living Room
The Living Room is a place of relaxation for you. Within you can see your comfortable couch and your big-screen TV.

You can see a couch (on which are a left throw pillow and a right throw pillow) here.

>examine left throw pillow
This isn't a throw pillow at all! It's actually a bag of flour!

>inventory
You are carrying:
  a bag of flour

* * *

>south
Living Room
The Living Room is a place of relaxation for you. Within you can see your comfortable couch and your big-screen TV.

You can see a couch (on which are a left throw pillow and a right throw pillow) here.

>take left throw pillow
You don't need a pillow to make a cake!

Taken.

>inventory
You are carrying:
  a left throw pillow

>look
Living Room
The Living Room is a place of relaxation for you. Within you can see your comfortable couch and your big-screen TV.

You can see a couch (on which is a right throw pillow) here.

* * *

>south
Living Room
The Living Room is a place of relaxation for you. Within you can see your comfortable couch and your big-screen TV.

You can see a couch (on which are a left throw pillow and a right throw pillow) here.

>down
Basement
Not much going on here. Basically, the laundry room for you.

You can see a washing machine (closed), a dryer (closed) and a powdered detergent here.

>take all
washing machine: It is too heavy to pick up!
dryer: It is too heavy to pick up!
powdered detergent: Now is not the time to do laundry...

>i
You are carrying nothing.

>open washing machine
You open the washing machine.

>enter washing machine
You get into the washing machine.

* * *

>down
Basement
Not much going on here. Basically, the laundry room for you.

You can see a washing machine (closed), a dryer (closed) and a powdered detergent here.

>open washing machine
You open the washing machine.

>enter washing machine
There doesn't seem to be any ingredients in this uncomfortable, tight space...

Basement
Not much going on here. Basically, the laundry room for you.

You can see a washing machine (empty), a dryer (closed) and a powdered detergent here.

* * *

>down
You can't go that way.

>south
Living Room
The Living Room is a place of relaxation for you. Within you can see your comfortable couch and your big-screen TV.

You can see a couch (on which are a left throw pillow and a right throw pillow) here.

>down
Basement
Not much going on here. Basically, the laundry room for you.

>look
Basement
Not much going on here. Basically, the laundry room for you.

* * *

>x self
As good-looking as ever.

>s
Living Room
The Living Room is a place of relaxation for you. Within you can see your comfortable couch and your big-screen TV. To the north is the Kitchen, to the east is the Bathroom, to the west is the Bedroom, to the south is the Backyard, upstairs is the Attic, and downstairs is the Basement.

You can see a couch (on which are a left throw pillow and a right throw pillow) here.

>x couch
On the couch are a left throw pillow and a right throw pillow.

>x left
This isn't a throw pillow at all! It's actually a bag of flour!

>take flour
Taken.

>x right
This isn't a throw pillow  either! It's actually a bag of sugar!

>x sugar
You see nothing special about the bag of sugar.

>x couch
On the couch is a bag of sugar.

>take sugar
Taken.

>i
You are carrying:
  a bag of sugar
  a bag of flour

>downstairs
Basement
Not much going on here. Basically, the laundry room for you. Upstairs is the Living Room.

You can see a washing machine (closed), a dryer (closed) and a powdered detergent here.

>x detergent
You see nothing special about the powdered detergent.

>x washing machine
You see nothing special about the washing machine.

>x dryer
You see nothing special about the dryer.

>open dryer
You open the dryer.

>x powdered detergent
You can't see any such thing.

>x dryer
The dryer is empty.

>open washing machine
You open the washing machine.

>x washing machine
The washing machine is empty.

>upstairs
Living Room
The Living Room is a place of relaxation for you. Within you can see your comfortable couch and your big-screen TV. To the north is the Kitchen, to the east is the Bathroom, to the west is the Bedroom, to the south is the Backyard, upstairs is the Attic, and downstairs is the Basement.

You can see a couch here.

>upstairs
Attic
Nothing going on here. Maybe an ingredient will be here later. Downstairs is the Living Room.

>downstairs
Living Room
The Living Room is a place of relaxation for you. Within you can see your comfortable couch and your big-screen TV. To the north is the Kitchen, to the east is the Bathroom, to the west is the Bedroom, to the south is the Backyard, upstairs is the Attic, and downstairs is the Basement.

You can see a couch here.

>e
Bathroom
The bathroom where you wash up and other bodily functions. To the west is the Living Room.

You can see a shower (in which is a bar of soap) here.

>x soap
This is really a stick of butter!

>take butter
Taken.

>x shower
The shower is empty.

>w
Living Room
The Living Room is a place of relaxation for you. Within you can see your comfortable couch and your big-screen TV. To the north is the Kitchen, to the east is the Bathroom, to the west is the Bedroom, to the south is the Backyard, upstairs is the Attic, and downstairs is the Basement.

You can see a couch here.

>w
Bedroom
The Bedroom: a place to rest your head after a long day's work. To the east is the Living Room.

You can see a nightstand (on which is a bottle of eyedrops) here.